# ***************************************************************************
# *
# *  Copyright (C) 2004-2010, International Business Machines
# *  Corporation; Unicode, Inc.; and others.  All Rights Reserved.
# *
# ***************************************************************************
# File: Macedonian_Latin_BGN.txt
# Generated from CLDR 
#
:: [АБВГДЃЕЖЗЅИЈКЛЉМНЊОПРСТЌУФХЦЧЏШабвгдѓежзѕијклљмнњопрстќуфхцчџш’] ;
:: NFD (NFC) ;
$prime  = ’ ;
$upperConsonants = [БВГДЃЖЗЅЈКЛЉМНЊПРСТЌФХЦЧЏШ] ;
$lowerConsonants = [бвгдѓжзѕјклљмнњпрстќфхцчџш’] ;
$consonants = [$upperConsonants $lowerConsonants] ;
$upperVowels = [АЕИОУ] ;
$lowerVowels = [аеиоу] ;
$vowels = [$upperVowels $lowerVowels] ;
$lower = [$lowerConsonants $lowerVowels] ;
$wordBoundary =  [^[:L:][:M:][:N:]] ;
А → A ; # CYRILLIC CAPITAL LETTER A
а → a ; # CYRILLIC SMALL LETTER A
Б → B ; # CYRILLIC CAPITAL LETTER BE
б → b ; # CYRILLIC SMALL LETTER BE
В → V ; # CYRILLIC CAPITAL LETTER VE
в → v ; # CYRILLIC SMALL LETTER VE
Г → G ; # CYRILLIC CAPITAL LETTER GHE
г → g ; # CYRILLIC SMALL LETTER GHE
Д → D ; # CYRILLIC CAPITAL LETTER DE
д → d ; # CYRILLIC SMALL LETTER DE
Ѓ}[ЕеИи] → G ; # CYRILLIC CAPITAL LETTER GJE
ѓ}[ЕеИи] → g ; # CYRILLIC SMALL LETTER GJE
Ѓ → Đ ; # CYRILLIC CAPITAL LETTER GJE
ѓ → đ ; # CYRILLIC SMALL LETTER GJE
Е → E ; # CYRILLIC CAPITAL LETTER DE
е → e ; # CYRILLIC SMALL LETTER DE
Ж → Ž ; # CYRILLIC CAPITAL LETTER ZHE
ж → ž ; # CYRILLIC SMALL LETTER ZHE
З → Z ; # CYRILLIC CAPITAL LETTER ZE
з → z ; # CYRILLIC SMALL LETTER ZE
Ѕ} $lower → Dz ; # CYRILLIC CAPITAL LETTER DZE
Ѕ → DZ ; # CYRILLIC CAPITAL LETTER DZE
ѕ → dz ; # CYRILLIC SMALL LETTER DZE
И → I ; # CYRILLIC CAPITAL LETTER I
и → i ; # CYRILLIC SMALL LETTER I
Ј → J ; # CYRILLIC CAPITAL LETTER JE
ј → J ; # CYRILLIC SMALL LETTER JE
К → K ; # CYRILLIC CAPITAL LETTER KA
к → k ; # CYRILLIC SMALL LETTER KA
Л → L ; # CYRILLIC CAPITAL LETTER EL
л → l ; # CYRILLIC SMALL LETTER EL
Љ} $lower → Lj ; # CYRILLIC CAPITAL LETTER LJE
Љ → LJ ; # CYRILLIC CAPITAL LETTER LJE
љ → lj ; # CYRILLIC SMALL LETTER LJE
М → M ; # CYRILLIC CAPITAL LETTER EM
м → m ; # CYRILLIC SMALL LETTER EM
Н → N ; # CYRILLIC CAPITAL LETTER EN
н → n ; # CYRILLIC SMALL LETTER EN
Њ} $lower → Nj ; # CYRILLIC CAPITAL LETTER NJE
Њ → NJ ; # CYRILLIC CAPITAL LETTER NJE
њ → nj ; # CYRILLIC SMALL LETTER NJE
О → O ; # CYRILLIC CAPITAL LETTER O
о → o ; # CYRILLIC SMALL LETTER O
П → P ; # CYRILLIC CAPITAL LETTER PE
п → p ; # CYRILLIC SMALL LETTER PE
Р → R ; # CYRILLIC CAPITAL LETTER ER
р → r ; # CYRILLIC SMALL LETTER ER
С → S ; # CYRILLIC CAPITAL LETTER ES
с → s ; # CYRILLIC SMALL LETTER ES
Т → T ; # CYRILLIC CAPITAL LETTER TE
т → t ; # CYRILLIC SMALL LETTER TE
Ќ}[ЕеИи] → K ; # CYRILLIC CAPITAL LETTER KJE
ќ}[ЕеИи] → k ; # CYRILLIC SMALL LETTER KJE
Ќ → C\u0301 ; # CYRILLIC CAPITAL LETTER KJE
ќ → c\u0301 ; # CYRILLIC SMALL LETTER KJE
У → U ; # CYRILLIC CAPITAL LETTER U
у → u ; # CYRILLIC SMALL LETTER U
Ф → F ; # CYRILLIC CAPITAL LETTER EF
ф → f ; # CYRILLIC SMALL LETTER EF
Х → H ; # CYRILLIC CAPITAL LETTER HA
х → h ; # CYRILLIC SMALL LETTER HA
Ц → C ; # CYRILLIC CAPITAL LETTER TSE
ц → c ; # CYRILLIC SMALL LETTER TSE
Ч → Č ; # CYRILLIC CAPITAL LETTER CHE
ч → č ; # CYRILLIC SMALL LETTER CHE
Џ} $lower → Dž ; # CYRILLIC CAPITAL LETTER SHA
Џ → DŽ ; # CYRILLIC CAPITAL LETTER SHA
џ → dž ; # CYRILLIC SMALL LETTER SHA
Ш → Š ; # CYRILLIC CAPITAL LETTER SHA
ш → š ; # CYRILLIC SMALL LETTER SHA
